40 14
1 1 1 1 1 1 1 1 1 1 1 1 1 1 1 1 1 1 1 1 1 1 1 1 1 1 1 1 1 1 1 1 1 1 1 1 1 1 1 1
1 1 1 1 1 1 1 1 1 1 1 1 1 1 1 1 1 1 1 1 1 1 1 1 1 1 1 1 1 1 1 1 1 1 1 1 1 1 1 1
1 1 1 1 1 1 1 1 1 1 1 1 1 1 1 1 1 1 1 1 1 1 1 1 1 1 1 1 1 1 1 1 1 1 1 1 1 1 1 1
1 3 1 1 1 1 1 1 1 1 1 1 1 1 1 1 1 1 1 1 1 1 1 1 1 1 1 1 1 1 1 1 1 1 1 1 1 1 1 1
1 1 1 1 1 1 1 1 1 1 1 1 1 1 1 1 1 1 1 1 1 1 1 1 1 1 1 1 1 1 1 1 1 1 1 1 1 1 1 1
1 1 1 1 1 1 1 1 1 1 1 1 1 0 0 0 1 1 1 1 1 1 1 1 1 0 0 0 1 1 1 1 1 1 1 1 0 1 1 1
1 1 1 1 1 1 1 1 1 1 1 0 0 0 0 0 0 0 1 1 1 1 1 0 0 0 0 0 0 0 1 1 1 1 1 0 0 0 1 1
1 1 1 1 1 1 1 1 1 1 1 0 0 0 7 0 0 0 1 1 1 1 1 0 0 0 7 0 0 0 1 1 1 1 0 0 0 0 0 1
1 1 1 1 1 1 1 1 1 1 1 1 1 1 12 1 1 1 1 1 0 1 1 1 1 1 7 1 1 1 1 1 1 1 1 1 7 1 1 1
1 1 1 1 1 0 1 1 1 1 1 1 1 1 13 1 1 1 1 0 0 1 1 1 1 1 7 1 1 1 1 0 1 1 1 1 7 1 1 1
1 1 1 9 0 0 0 17 1 1 1 1 1 1 7 1 1 1 1 0 0 0 1 1 1 1 4 1 1 1 0 0 0 1 1 1 7 1 1 1
1 1 1 0 0 0 0 0 1 1 1 1 1 1 7 1 1 1 0 0 0 0 0 1 1 1 7 1 1 1 0 0 0 1 1 1 7 1 1 1
8 8 8 8 8 8 8 8 8 8 8 8 8 8 8 8 8 8 8 8 8 8 8 8 8 8 8 8 8 8 8 8 8 8 8 8 8 8 8 8
2 2 2 2 2 2 2 2 2 2 2 2 2 2 2 2 2 2 2 2 2 2 2 2 2 2 2 2 2 2 2 2 2 2 2 2 2 2 2 2