30 20
1 1 1 1 1 1 1 1 1 1 1 1 1 1 1 1 1 1 1 1 1 1 1 1 1 1 1 1 1 1
1 1 1 1 1 1 1 1 1 1 1 1 1 7 1 1 1 1 1 1 1 1 1 1 1 1 1 1 1 1
1 1 1 1 1 1 1 1 1 1 1 1 1 7 1 1 1 1 1 1 1 1 1 1 1 1 1 16 16 1
1 1 1 1 1 1 1 1 1 1 1 1 5 7 1 1 1 1 1 1 1 1 1 1 1 1 1 1 16 1
1 1 1 1 1 1 1 1 1 1 1 1 1 7 11 6 1 1 1 1 1 16 16 16 16 1 1 1 16 1
1 1 1 1 1 1 1 1 1 1 1 1 1 7 1 1 1 1 1 1 1 1 1 1 16 1 1 1 16 1
1 1 1 1 1 1 1 1 1 1 1 11 11 7 1 1 1 1 1 1 1 1 1 1 16 1 1 1 16 1
1 1 1 1 1 1 1 1 1 1 1 1 1 7 1 1 1 1 1 1 1 1 1 1 16 1 16 1 16 1
1 1 1 1 1 1 1 1 1 1 1 1 1 7 1 1 1 1 1 1 1 1 1 1 16 1 1 1 16 1
1 1 1 1 1 1 1 1 1 1 1 1 1 7 1 1 1 1 1 1 1 1 1 1 16 1 1 1 16 1
1 1 1 1 0 1 0 1 0 1 1 1 1 7 11 6 1 1 1 1 1 16 16 16 16 1 1 16 16 1
1 1 1 1 0 0 0 0 0 1 1 5 11 7 1 1 1 1 1 1 1 1 1 1 16 1 1 1 16 1
1 1 1 1 1 1 0 1 1 1 1 1 1 7 1 1 1 1 1 1 1 1 1 1 16 1 1 1 16 1
1 1 1 0 1 1 0 1 1 0 5 11 11 7 1 1 1 1 1 1 1 1 1 1 16 16 1 1 16 1
1 1 1 0 1 1 0 17 1 0 1 1 1 7 1 1 1 1 1 1 1 1 1 1 1 1 1 1 16 1
16 16 16 0 0 0 0 0 0 0 1 1 1 7 16 16 16 14 14 14 14 16 16 16 16 16 16 16 16 1
16 16 16 1 1 1 0 1 1 1 1 1 1 7 16 16 16 15 15 15 15 16 16 16 16 16 16 16 16 1
2 2 2 2 2 2 2 2 2 2 2 2 2 2 2 2 2 15 15 15 15 2 2 2 2 2 2 2 2 2
2 2 2 2 2 2 2 2 2 2 2 2 2 2 2 2 2 15 15 15 15 2 2 2 2 2 2 2 2 2
2 2 2 2 2 2 2 2 2 2 2 2 2 2 2 2 2 2 2 2 2 2 2 2 2 2 2 2 2 2