62 15
1 1 1 1 1 1 1 1 1 1 1 1 1 1 1 1 1 1 1 1 1 1 1 1 1 1 1 1 1 1 1 1 1 1 1 1 1 1 1 1 1 1 1 1 1 1 1 1 1 1 1 1 1 1 1 1 1 1 1 1 1 1
1 1 1 1 1 1 1 1 1 1 1 1 1 1 1 1 1 1 1 1 1 1 1 1 1 1 1 1 1 1 1 1 1 1 1 1 1 1 1 1 1 1 1 1 1 1 1 1 1 1 1 1 1 1 1 1 1 1 1 1 1 1
1 1 1 1 1 1 1 1 1 1 1 1 1 1 1 1 1 1 1 1 1 1 1 1 1 1 1 1 1 1 1 1 1 1 1 1 1 1 1 1 1 1 1 1 1 1 1 1 1 1 1 1 1 1 1 1 1 1 1 1 1 1
1 1 1 1 1 1 1 1 1 1 1 1 1 1 1 1 1 1 1 1 1 1 1 1 1 1 1 1 1 1 1 1 1 1 1 1 1 1 1 1 1 1 1 1 1 1 1 1 1 1 1 1 1 1 1 1 1 1 1 1 1 1
1 1 1 1 1 1 1 1 1 1 1 1 1 1 1 1 1 1 1 1 1 1 1 1 1 1 1 1 1 1 1 1 1 1 1 1 1 1 1 1 1 1 1 1 1 1 1 1 1 1 1 1 1 1 1 1 1 1 1 1 1 1
1 3 1 1 1 1 1 1 1 1 1 1 1 1 1 1 1 1 1 1 1 1 1 1 1 1 1 1 1 1 1 1 1 1 1 1 1 1 1 1 1 1 1 1 1 1 1 1 1 1 1 1 1 16 16 1 1 1 1 1 1 1
1 1 1 1 1 1 1 1 1 1 1 1 1 1 1 1 1 1 1 1 1 1 1 1 1 1 1 1 1 1 1 1 1 1 1 1 1 1 1 1 1 16 16 1 1 1 1 16 16 1 1 1 1 16 16 1 1 1 1 16 16 1
1 1 1 1 1 1 1 1 1 1 1 1 1 1 8 1 1 1 1 1 1 1 1 1 1 1 1 1 1 1 1 1 1 1 1 1 1 1 1 1 1 16 16 1 1 1 16 16 16 1 1 1 16 16 16 1 1 1 16 16 16 1
1 1 1 1 1 1 17 1 1 1 1 1 1 8 8 8 1 1 1 1 1 1 1 1 1 1 1 1 1 1 1 1 1 1 1 1 1 1 1 1 1 16 16 1 1 1 1 16 16 1 1 1 1 16 16 1 1 1 1 16 16 1
1 1 1 1 1 8 8 8 1 1 1 1 8 8 8 8 8 1 1 1 1 1 1 1 1 16 1 1 1 1 1 16 1 1 1 1 1 1 1 1 1 16 16 16 1 1 1 16 16 16 1 1 1 16 16 16 1 1 1 16 16 1
1 1 1 1 1 8 8 8 1 1 1 1 1 1 7 1 1 1 1 1 1 1 1 16 1 16 1 1 16 1 1 1 1 1 16 1 1 1 1 1 1 16 16 1 1 1 1 16 16 1 1 1 1 16 16 1 1 1 1 16 16 1
1 1 1 1 1 1 7 1 1 1 1 5 11 11 4 1 1 1 1 1 1 16 1 16 1 16 1 1 1 1 1 1 1 1 1 1 1 1 1 1 1 16 16 1 1 1 16 16 16 1 1 1 16 16 16 1 1 1 16 16 16 1
1 1 1 1 11 11 7 1 1 1 1 1 1 1 7 11 6 1 1 16 1 16 1 16 1 16 1 1 1 1 1 1 1 1 1 1 1 1 1 1 1 1 1 1 1 1 1 16 16 1 1 1 1 16 16 1 1 1 1 16 16 1
1 1 1 1 1 1 7 1 1 1 1 1 1 1 7 1 1 1 1 16 1 16 1 16 1 16 14 14 14 14 14 14 14 14 14 14 14 16 16 16 16 16 16 1 1 1 1 16 16 1 1 1 1 16 16 1 1 1 1 16 16 1
0 0 0 0 0 0 0 0 0 0 0 0 0 0 0 0 0 16 16 16 16 16 16 16 16 16 15 15 15 15 15 15 15 15 15 15 15 16 16 16 16 16 16 16 16 16 16 16 16 16 16 16 16 16 16 16 16 16 16 16 16 1